XXXXXXXXXXXX
XXXqXXXXXXXX
XXX XXXXXXXX
XXXXX XXXXXX
X X XXX Xa X
            
            
XXXXXaXXX XX
XXXXXXXXX  X
XXX  XXXXXXX
XXXXXX XXXXX
XXXXXXXXXXXX
