XXXXXXXXXXXX
XXXXXXXXXXXX
XXXXXXX XXXX
XXXXXXX XXXX
XX XX X XXXX
      q     
    q       
XXX   X  XXX
XXXX qXXXXXX
XXXX XXXXXXX
XXXXXXXXXXXX
XXXXXXXXXXXX
