XXXXXXXXXXXX
XX        XX
XXqXXXXXX XX
XX XXXXXX XX
XY XXXXXX YX
   XXXXXX   
   XXXXXX   
XY XXXXXX YX
XX XXXXXX XX
XX XXXXXXqXX
XX        XX
XXXXXXXXXXXX
