XXXXXXXXXXXX
XXXXXXXXXXXX
XXXXXXXXXXXX
XXXXXXXXXXXX
XXXXXXXXXXXX
       XXXXX
       XXXXX
XXXXX  XXXXX
XXXXX  XXXXX
XXXXX  XXXXX
XXXXX  XXXXX
XXXXX  XXXXX