XXXXX  XXXXX
XXXX   XXXXX
XXXXX  XXXXX
Xq X   XX XX
XXXXX  XX XX
XXX X  aXXXX
XXXXX  XXX X
XXXX   XXXXX
XXXXX  XXXXX
XXXXa    XXX
XXXX   X XXX
XXXXX  XXXXX