XXXXX  XXXXX
XXXXX  XXXXX
XXXXX  XXXXX
XXXXX  XXXXX
XXXXX qXXXXX
XXXXX  XXXXX
XXXXXq XXXXX
XXXXX  XXXXX
XXXXX  XXXXX
XXXXX  XXXXX
XXXXX  XXXXX
XXXXX  XXXXX