XXXXX  XXXXX
XXXXX  XXXXX
XXXX   XXXXX
XXXXX   XXXX
XXXXX q   XX
XXXX    qXXX
XXXXXq XXXXX
XX      XXXX
XXXXX   XXXX
XXXXX  XXXXX
XXXXX  XXXXX
XXXXX  XXXXX