XXXXX  XXXXX
XXXXY  YXXXX
X q        X
X XXXXXXXX X
X XXXXXXXX X
X XXXXXXXX X
X XXXXXXXX X
X XXXXXXXX X
X XXXXXXXX X
X        q X
XXXXY  YXXXX
XXXXX  XXXXX