XXXXX  XXXXX
XXXXX  XXXXX
XXXXX  XXXXX
XXXXX  XXXXX
XXXXX wXXXXX
XXXXX  XXXXX
XXXXX  XXXXX
XXXXXw XXXXX
XXXXX  XXXXX
XXXXX  XXXXX
XXXXX  XXXXX
XXXXX  XXXXX