XXXXX  XXXXX
XXXXXX XXXXX
XXXXXX XXXXX
XXXXXX XXXXX
XXXXX  XXXXX
XXXXXwXXXXXX
XXXXX XXXXXX
XXXXX XXXXXX
XXXXX  XXXXX
XXXXXX XXXXX
XXXXXX XXXXX
XXXXX  XXXXX