XXXXX  XXXXX
XXXXXX XXXXX
XXXXX  XXXXX
XXXXX XXXXXX
XXXXX  XXXXX
XXXXXe XXXXX
XXXXX  XXXXX
XXXXX  XXXXX
XXXXXX XXXXX
XXXXX  XXXXX
XXXXX XXXXXX
XXXXX  XXXXX