XXXXX  XXXXX
XXXXX  XXXXX
XXXXX  XXXXX
XXXXX  XXXXX
XXXXX  XXXXX
       XXXXX
       XXXXX
XXXXXXXXXXXX
XXXXXXXXXXXX
XXXXXXXXXXXX
XXXXXXXXXXXX
XXXXXXXXXXXX