XXXXX  XXXXX
XXXXXX XXXXX
XXXXX  XXXXX
XXXXX XXXXXX
XXXXX  XXXXX
 XXXXX s    
      sXXXX 
XXXXXX XXXXX
XXX    XXXXX
XXX XXXXXXXX
XXX   XXXXXX
XXXXX  XXXXX